1 1 1 1 1 1 1 1 1 1
1 0 1 1 1 0 1 1 1 1
1 1 0 1 0 1 0 1 0 1
1 0 1 0 0 1 1 1 1 1
1 0 1 1 1 0 0 1 1 1
1 1 0 0 1 1 0 0 0 1
1 0 1 1 0 0 1 1 0 1
1 1 1 1 1 1 1 1 1 1
1 1 1 1 1 1 1 1 1 1
1 1 1 1 1 1 1 1 1 1

//教材
//只能8个方向有路径
// 10 1 1 6 8